2 2 4 0 5 0 0 0 0 0 0 0 2 2 2 2
2 2 4 4 5 0 5 0 0 0 5 0 2 2 2 2
2 2 2 2 5 5 5 5 0 0 5 5 0 2 2 2
2 2 2 4 5 5 5 0 5 0 0 0 0 2 2 2
2 2 2 2 2 0 0 5 5 5 2 0 0 2 2 2
2 2 2 2 2 0 2 2 2 2 2 2 2 2 2 2
2 2 2 2 2 0 2 2 2 2 2 2 2 2 2 2
2 2 2 2 2 0 2 2 2 2 2 2 2 2 2 2
2 2 2 2 2 0 2 2 2 2 2 2 2 2 2 2
2 2 2 5 5 0 2 2 2 2 2 2 2 2 2 2
2 2 5 5 5 0 0 0 0 0 0 0 0 2 2 2
2 2 0 0 0 0 0 0 0 0 0 0 0 0 0 2