13 12 12 12 12 12 12 12 12 12 12 12 12 12 12 12 12 12 12 12 12 12 12 12 12 12 12 12 12 12 12 12 12 12 12 12 12 12 12 12 12 12 12 12 12 12 12 12 12 12 12 12 12 12 12 12 12 13 
13 12 12 12 12 12 12 12 12 12 12 12 12 12 12 12 12 12 12 12 12 12 12 12 12 12 12 12 12 12 12 12 12 12 12 12 12 12 12 12 12 12 12 12 12 12 12 12 12 12 12 12 12 12 12 12 12 13 
13 12 12 12 12 12 12 12 12 12 12 12 12 12 12 12 12 12 12 18 18 18 18 18 18 18 18 18 18 18 12 12 15 15 15 15 15 15 15 15 15 15 15 15 15 15 15 15 15 15 15 15 15 12 12 12 12 13 
13 12 12 12 12 12 12 12 12 12 12 12 12 12 12 12 12 12 12 18 12 12 12 12 12 12 12 12 12 12 12 12 15 12 12 12 12 12 12 12 12 12 12 12 12 12 12 12 12 12 12 12 15 12 12 12 12 13 
13 12 12 12 12 12 12 12 12 12 12 12 12 12 12 12 12 12 12 18 12 12 12 12 12 12 12 12 12 12 12 12 15 12 16 16 16 16 12 12 12 12 12 12 12 12 12 12 12 12 12 12 15 12 12 12 12 13 
13 12 12 12 12 12 12 12 12 12 12 12 12 12 12 12 12 12 12 18 12 12 12 12 12 12 12 12 12 12 12 12 15 12 16 16 16 16 12 12 12 12 12 12 12 12 12 12 12 12 12 12 15 12 12 12 12 13 
13 12 12 12 12 12 12 12 12 12 12 12 12 12 12 12 12 12 12 18 12 12 12 12 12 12 12 12 12 12 12 12 15 12 16 16 16 16 12 12 12 12 12 12 12 12 12 12 12 12 12 12 15 12 12 12 12 13 
13 12 12 12 12 12 12 12 12 12 12 12 12 12 12 12 12 12 12 18 12 12 12 12 12 12 12 12 12 12 12 12 12 12 16 16 16 16 12 12 12 12 12 12 12 12 12 12 12 12 12 12 15 12 12 12 12 13 
13 12 12 15 15 12 15 15 15 15 15 15 15 15 15 15 15 15 12 18 12 12 12 12 12 12 12 12 12 12 12 12 15 12 16 16 16 16 12 12 12 12 12 12 12 12 12 12 12 12 12 12 15 12 12 12 12 13 
13 12 12 15 12 12 12 12 12 12 12 12 12 12 12 12 12 15 12 18 12 12 12 12 12 12 12 12 12 12 12 12 15 12 16 16 16 16 12 12 12 12 12 12 12 12 12 12 12 12 12 12 15 12 12 12 12 13 
13 12 12 15 12 12 12 12 12 12 12 12 12 12 12 12 12 15 12 18 12 12 12 12 12 12 12 12 12 12 12 12 15 12 16 16 16 16 12 12 12 12 12 12 12 12 12 12 12 12 12 12 15 12 12 12 12 13 
13 12 12 15 12 12 12 12 12 12 12 12 12 12 12 12 12 15 12 18 12 12 12 12 12 12 12 12 12 12 12 12 15 12 12 12 12 12 12 12 12 12 12 12 12 12 12 12 12 12 12 12 15 12 12 12 12 13 
13 12 12 15 12 12 12 12 12 12 12 12 12 12 12 12 12 15 12 18 12 12 12 12 12 12 12 12 12 12 12 12 15 15 15 15 15 15 15 15 15 15 15 15 15 15 15 15 15 15 15 15 15 12 12 12 12 13 
13 12 12 15 12 12 12 12 12 12 12 12 12 12 12 12 12 15 12 12 12 12 12 12 12 12 12 12 12 12 12 12 12 12 12 12 12 12 12 12 12 12 12 12 12 12 12 12 12 12 12 12 12 12 12 12 12 13 
13 12 12 15 12 12 12 12 12 12 12 12 12 12 12 12 12 15 12 12 12 12 12 12 12 12 12 12 12 12 12 12 12 12 12 12 12 12 12 12 12 12 12 12 12 12 12 12 12 12 12 12 12 12 12 12 12 13 
13 12 12 15 12 12 12 12 12 12 12 12 12 12 12 12 12 15 12 12 16 16 16 16 16 16 16 16 16 16 16 16 16 16 12 15 15 15 15 15 15 15 15 15 15 15 15 15 15 15 15 15 15 15 15 15 15 13 
13 12 12 15 12 12 12 12 12 12 12 12 12 12 12 12 12 15 12 12 16 16 16 16 16 16 16 16 16 16 16 16 16 16 12 15 11 11 11 11 11 11 11 14 11 11 11 11 11 11 11 11 11 11 11 11 15 13 
13 12 12 15 15 15 15 15 15 15 15 15 15 15 15 15 15 15 12 12 16 16 16 16 16 16 16 16 16 16 16 16 16 16 12 15 11 11 11 11 11 11 11 14 14 11 14 11 11 11 11 11 11 11 11 11 15 13 
13 12 12 12 12 12 12 12 12 12 12 12 12 12 12 12 12 12 12 12 16 16 16 16 16 16 16 16 16 16 16 16 16 16 12 15 11 11 11 11 11 11 11 14 14 11 14 11 11 11 11 11 11 11 11 11 15 13 
13 12 12 12 12 12 12 12 12 12 12 12 12 12 12 12 12 12 12 12 16 16 16 16 16 16 16 16 16 16 16 16 16 16 12 15 11 11 11 11 11 11 14 14 14 14 14 11 11 11 11 11 11 11 11 11 15 13 
13 12 12 12 12 12 12 12 12 12 12 12 12 12 12 12 12 17 17 12 16 16 16 16 16 16 16 16 16 16 16 16 16 16 12 15 11 11 11 11 11 14 14 14 14 14 14 11 11 11 11 11 11 11 11 11 15 13 
13 12 12 12 12 12 12 12 12 12 12 12 12 12 12 12 12 17 17 12 16 16 16 16 16 16 16 16 16 16 16 16 16 16 12 15 11 11 11 11 11 14 11 14 14 14 14 11 11 11 11 11 11 11 11 11 15 13 
13 12 12 12 12 12 12 12 12 12 12 12 12 12 12 12 12 17 17 12 16 16 16 16 16 16 16 16 16 16 16 16 16 16 12 15 11 11 11 11 11 14 11 14 14 14 11 11 11 11 11 11 11 11 11 11 15 13 
13 12 12 12 12 12 12 12 12 12 12 12 12 12 12 12 12 17 17 12 16 16 16 16 16 16 16 16 16 16 16 16 16 16 12 15 11 11 11 11 11 11 11 14 11 14 11 11 11 11 11 11 11 11 11 11 15 13 
13 12 12 12 12 12 12 12 12 12 12 12 12 12 12 12 12 17 17 12 16 16 16 16 16 16 16 16 16 16 16 16 16 16 12 15 11 11 11 11 11 11 11 14 11 11 11 11 11 11 11 11 11 11 11 11 15 13 
13 12 12 12 12 12 12 12 12 12 12 12 12 12 12 12 12 17 17 12 16 16 16 16 16 16 16 16 16 16 16 16 16 16 12 15 11 11 11 11 11 11 11 11 11 11 11 11 11 11 11 11 11 11 11 11 15 13 
13 12 12 12 12 12 12 12 12 12 12 12 12 12 12 12 12 17 17 12 16 16 16 16 16 16 16 16 16 16 16 16 16 16 12 15 15 15 12 15 15 15 15 15 15 15 15 15 15 15 15 15 15 15 15 15 15 13 
13 12 12 12 12 12 12 12 12 12 12 12 12 12 12 12 12 17 17 12 12 12 12 12 12 12 12 12 12 12 12 12 12 12 12 12 12 12 12 12 12 12 12 12 12 12 12 12 12 12 12 12 12 12 12 12 12 13 
13 12 12 12 12 12 12 12 12 12 12 12 12 12 12 12 12 17 17 12 12 12 12 12 12 12 12 12 12 12 12 12 12 12 12 12 12 12 12 12 12 12 12 12 12 12 12 12 12 12 12 12 12 12 12 12 12 13 
13 12 18 18 18 18 18 18 18 18 18 18 18 18 18 18 18 18 18 12 12 12 12 15 15 15 15 15 15 15 15 15 15 15 15 15 15 15 12 12 12 12 12 12 12 12 12 12 12 12 12 12 12 12 12 12 12 13
13 12 18 18 18 18 18 18 18 18 18 18 18 18 18 18 18 18 18 12 12 12 12 15 12 12 12 12 12 12 12 12 12 12 12 12 12 15 12 16 16 16 16 16 16 16 16 12 17 17 12 18 18 12 12 12 12 13
13 12 12 12 12 12 12 12 12 12 12 12 12 12 12 12 12 12 12 12 12 12 12 15 12 12 12 12 12 12 12 12 12 12 12 12 12 15 12 16 16 16 16 16 16 16 16 12 17 17 12 18 18 12 12 12 12 13
13 12 15 15 15 15 15 15 15 15 15 15 15 15 15 15 15 15 15 12 12 12 12 15 12 12 12 12 12 12 12 12 12 12 12 12 12 15 12 16 16 16 16 16 16 16 16 12 17 17 12 18 18 12 12 12 12 13 
13 12 15 11 11 11 11 11 11 11 11 11 11 11 11 11 11 11 15 12 12 12 12 15 12 12 12 12 12 12 12 12 12 12 12 12 12 15 12 16 16 16 16 16 16 16 16 12 17 17 12 18 18 12 12 12 12 13 
13 12 15 11 11 14 11 11 11 14 11 11 11 11 11 11 11 11 15 12 12 12 12 15 12 12 12 12 12 12 12 12 12 12 12 12 12 15 12 16 16 16 16 16 16 16 16 12 17 17 12 18 18 12 12 12 12 13 
13 12 15 11 11 11 11 11 11 11 11 11 11 11 11 11 11 11 15 12 12 12 12 15 12 12 12 12 12 12 12 12 12 12 12 12 12 15 12 16 16 16 16 16 16 16 16 12 17 17 12 18 18 12 12 12 12 13 
13 12 15 11 14 14 11 14 11 11 14 11 11 11 11 11 11 11 15 12 12 12 12 15 15 15 15 15 15 15 12 15 15 15 15 15 15 15 12 16 16 16 16 16 16 16 16 12 17 17 12 18 18 12 12 12 12 13 
13 12 15 14 14 14 11 14 11 11 11 11 11 11 11 11 11 11 15 12 12 12 12 12 12 12 12 12 12 12 12 12 12 12 12 12 12 12 12 16 16 16 16 16 16 16 16 12 17 17 12 18 18 12 12 12 12 13 
13 12 15 11 11 14 14 11 11 11 11 14 11 11 11 11 11 11 15 12 12 12 12 17 17 17 17 17 17 17 17 17 17 17 17 17 17 17 12 16 16 16 16 16 16 16 16 12 17 17 12 18 18 12 12 12 12 13 
13 12 15 11 11 11 11 11 11 11 11 11 11 11 11 11 11 11 15 12 12 12 12 17 17 17 17 17 17 17 17 17 17 17 17 17 17 17 12 16 16 16 16 16 16 16 16 12 17 17 12 18 18 12 12 12 12 13 
13 12 15 15 15 15 15 15 15 12 15 15 15 15 15 15 15 15 15 12 12 12 12 12 12 12 12 12 12 12 12 12 12 12 12 12 12 12 12 12 12 12 12 12 12 12 12 12 12 12 12 12 12 12 12 12 12 13 
13 12 12 12 12 12 12 12 12 12 12 12 12 12 12 12 12 12 12 12 12 12 12 12 12 12 12 12 12 12 12 12 12 12 12 12 12 12 12 12 12 12 12 12 12 12 12 12 12 12 12 12 12 12 12 12 12 13 
13 12 12 12 12 12 12 12 12 12 12 12 12 12 12 12 12 12 12 12 12 12 12 12 12 12 12 12 12 12 12 12 12 12 12 12 12 12 12 12 12 12 12 12 12 12 12 12 12 12 12 12 12 12 12 12 12 13 
13 13 13 13 13 13 13 13 13 13 13 13 13 13 13 13 13 13 13 13 13 13 13 13 13 13 13 13 12 12 12 12 13 13 13 13 13 13 13 13 13 13 13 13 13 13 13 13 13 13 13 13 13 13 13 13 13 13 
3 3 3 3 3 3 2 2 2 2 2 2 2 2 2 2 2 2 2 2 2 2 2 2 2 2 2 2 13 13 4 13 2 2 2 2 2 2 2 2 2 2 2 2 2 2 2 2 2 2 2 2 2 2 2 2 2 2 3
3 3 3 3 3 3 2 2 2 2 2 2 2 2 2 2 2 2 2 2 2 2 2 2 2 2 2 2 5 5 5 5 2 2 2 2 2 2 2 2 2 2 2 2 2 2 2 2 2 2 2 2 2 3 3 3 3 3 3
3 3 3 3 3 3 2 2 2 2 2 2 2 2 2 4 5 5 5 5 5 5 5 5 5 5 5 5 5 5 5 5 2 2 2 2 2 2 2 2 2 2 2 2 2 2 2 2 2 2 2 2 2 3 3 3 3 3 3
3 3 3 3 3 3 2 2 2 2 2 2 2 2 2 3 5 5 5 5 5 5 5 5 5 5 5 5 5 5 5 5 2 2 2 2 2 2 2 2 2 2 2 2 2 2 2 2 2 2 2 2 2 3 3 3 3 3 3
3 3 3 3 2 2 2 2 2 2 2 2 2 2 2 4 5 5 4 4 4 4 4 4 4 4 4 4 4 4 4 4 2 2 2 2 2 2 2 2 2 2 2 2 2 2 2 2 2 2 2 2 2 3 4 3 3 3 3
3 2 2 5 5 6 6 6 9 6 6 6 6 6 8 6 5 5 2 2 2 2 2 2 2 2 2 2 2 2 2 2 2 2 2 2 2 2 2 2 2 2 2 2 2 2 2 2 2 2 2 2 2 3 3 3 3 3 3
3 2 2 5 5 6 8 6 6 6 6 6 6 6 6 6 5 5 2 2 2 2 2 2 2 2 2 2 2 2 2 2 2 2 2 2 2 2 2 2 2 2 2 2 2 2 2 2 2 2 2 2 2 5 5 5 3 3 3
3 2 2 5 5 2 2 2 2 2 2 2 2 2 2 2 2 2 2 2 2 2 2 2 2 2 2 2 2 2 2 2 2 2 2 2 2 2 2 2 2 2 2 2 2 2 2 2 2 2 2 2 2 5 5 5 2 2 3
3 2 2 5 5 2 2 2 2 2 2 2 2 2 2 2 2 2 2 2 2 2 2 2 2 2 2 2 2 5 5 5 5 5 5 5 5 5 5 5 5 5 5 5 5 5 5 5 5 5 5 5 5 5 5 5 2 2 3
3 2 2 5 5 2 2 2 2 2 2 2 2 2 2 2 2 2 2 2 2 2 2 2 2 2 2 2 2 5 5 6 6 6 5 5 5 5 5 5 6 6 9 9 8 0 6 6 6 0 5 5 5 5 5 5 2 2 3
3 2 2 5 5 2 2 2 2 2 2 2 2 2 2 2 2 2 2 2 2 2 2 2 2 2 2 2 2 5 5 2 2 2 5 5 2 2 2 2 2 2 2 2 2 2 2 2 2 2 2 2 2 2 5 5 2 2 3
3 2 2 5 5 2 2 2 2 2 2 2 2 2 2 2 2 2 2 2 2 2 2 2 2 2 2 2 2 5 5 2 2 8 5 5 2 2 2 2 2 2 2 2 2 2 2 2 2 2 2 2 2 2 5 5 2 2 3
3 2 2 5 5 2 2 2 2 2 2 2 2 2 2 2 2 2 2 2 2 2 2 2 2 2 2 2 2 5 5 2 2 8 5 5 2 2 2 2 2 2 2 2 2 2 2 2 2 2 2 2 2 2 5 5 2 2 3
3 2 2 5 5 2 2 2 2 2 2 2 2 2 2 2 2 2 2 2 2 2 2 2 2 2 2 2 2 5 5 2 2 8 5 5 2 2 2 2 2 2 2 2 2 2 2 2 2 2 2 2 2 2 5 5 2 2 3
3 2 2 5 5 2 2 2 2 2 2 2 2 2 2 2 2 2 2 2 2 2 2 2 2 2 2 2 2 5 5 2 2 8 5 5 2 2 2 2 2 2 2 2 2 2 2 2 2 2 2 2 2 2 5 5 2 2 3
3 2 2 5 5 2 2 2 2 2 2 2 2 2 2 2 2 2 2 2 2 2 2 2 2 2 2 2 2 5 5 2 2 9 5 5 2 2 2 2 2 2 2 2 2 2 2 2 2 2 2 2 2 2 5 5 2 2 3
3 2 2 5 5 2 2 2 2 2 2 2 2 2 2 2 2 2 2 2 2 2 2 2 2 2 2 2 2 5 5 2 2 8 5 5 6 6 6 6 6 6 6 6 2 2 2 2 2 2 2 2 2 2 5 5 2 2 3
3 2 2 5 5 5 5 5 5 5 5 5 5 5 5 6 6 2 2 2 2 2 2 2 2 2 2 2 2 5 5 2 2 9 5 5 5 5 5 5 5 5 5 5 2 2 2 2 2 2 2 2 2 2 5 5 2 2 3
3 2 2 5 5 5 5 5 5 5 5 5 5 5 5 6 8 2 2 2 2 2 2 2 2 2 2 2 0 5 5 2 2 2 2 2 2 2 2 2 2 2 5 5 2 2 2 2 2 2 2 2 2 2 5 5 2 2 3
3 2 2 2 2 2 2 2 2 2 2 2 2 2 2 6 9 2 2 2 2 2 2 2 2 2 2 2 0 5 5 2 2 2 2 2 2 2 2 2 2 2 5 5 2 2 2 2 2 2 2 2 2 2 5 5 2 2 3
3 2 2 2 2 2 2 2 2 2 2 2 2 2 2 6 6 6 6 6 6 6 5 5 5 5 5 5 5 5 5 2 2 2 2 2 2 2 2 2 2 2 5 5 2 2 2 2 2 2 2 2 2 2 5 5 2 2 3
3 2 2 2 2 2 2 2 2 2 2 2 2 2 2 6 9 6 8 6 6 9 5 5 5 5 5 5 5 5 5 2 2 2 2 2 2 2 2 2 2 2 5 5 2 2 2 2 2 2 2 2 2 2 5 5 2 2 3
3 2 2 2 2 2 2 2 2 2 2 2 2 2 2 2 2 2 2 2 2 2 2 2 2 2 2 2 2 5 5 4 2 2 2 2 2 2 2 2 2 2 5 5 2 2 2 2 2 2 2 2 2 2 5 5 2 2 3
3 2 2 2 2 2 2 2 2 2 2 2 2 2 2 2 2 2 2 2 2 2 2 2 2 2 2 2 2 5 5 2 2 2 2 2 2 2 2 2 2 2 5 5 2 2 2 2 2 2 2 2 2 2 5 5 2 2 3
3 2 2 2 2 2 2 2 2 2 2 2 2 2 2 2 2 2 2 2 2 2 2 2 2 2 2 2 2 5 5 2 2 2 2 2 2 2 2 2 2 2 5 5 2 2 2 2 2 2 2 2 2 2 5 5 2 2 3
3 2 2 2 2 2 2 2 2 2 2 2 2 2 2 2 2 2 2 2 2 2 2 2 2 2 2 2 2 5 5 2 2 2 2 2 2 2 2 2 2 2 5 5 2 2 2 2 2 2 2 2 2 2 5 5 2 2 3
3 2 2 2 2 2 2 2 2 2 2 2 2 2 2 2 2 2 2 2 2 2 2 2 2 2 2 4 4 5 5 2 2 2 2 2 2 2 2 2 2 2 5 5 2 2 2 2 2 2 2 2 2 2 5 5 2 2 3
3 2 2 2 2 2 2 2 2 2 2 2 2 2 2 2 2 2 2 2 2 2 2 2 2 2 2 4 3 5 5 2 2 2 2 2 2 2 2 2 2 2 5 5 2 2 2 2 2 2 2 2 2 2 5 5 2 2 3
3 2 2 2 2 2 2 2 2 2 2 2 2 2 2 2 2 2 2 2 2 2 2 2 2 2 2 4 3 5 5 2 2 2 2 2 4 4 4 4 4 2 5 5 2 2 2 2 2 2 2 2 2 2 5 5 2 2 3
3 2 2 2 2 2 5 5 5 5 5 5 5 5 5 5 5 5 5 5 5 5 5 5 5 5 5 5 5 5 5 5 5 5 5 5 6 6 9 6 6 6 9 6 2 2 2 2 2 2 2 2 2 2 5 5 2 2 3
3 2 2 2 2 2 5 5 5 5 5 5 5 5 5 5 5 5 5 5 5 5 5 5 5 5 5 5 5 5 5 5 5 5 5 5 5 5 5 5 5 5 5 5 2 2 2 2 2 2 2 2 2 2 5 5 2 2 3
3 2 2 2 2 2 5 5 2 2 2 2 2 2 2 2 2 2 2 2 2 2 2 2 2 2 2 2 5 5 2 2 2 2 2 2 2 2 2 2 2 2 2 2 2 2 2 2 2 2 2 2 2 2 5 5 2 2 3
3 2 2 2 2 2 5 5 2 2 2 2 2 2 2 2 2 2 2 2 2 2 2 2 2 2 2 2 5 5 2 2 2 2 2 2 2 2 2 2 2 2 2 2 2 2 2 2 2 2 2 2 2 2 5 5 2 2 3
3 2 2 2 2 2 5 5 2 2 2 2 2 2 2 2 2 2 2 2 2 2 2 2 2 2 2 2 5 5 2 2 2 2 2 2 2 2 2 2 2 2 2 2 2 2 2 2 2 2 2 2 2 2 5 5 2 2 3
3 2 2 2 2 2 5 5 2 2 2 2 2 2 2 2 2 2 2 2 2 2 2 2 2 2 2 2 5 5 2 2 2 2 2 2 2 2 2 2 2 2 2 2 2 2 2 2 2 2 2 2 2 2 5 5 2 2 3
3 2 2 2 2 2 5 5 2 2 2 2 2 2 2 2 2 2 2 2 2 2 2 2 2 2 2 2 5 5 2 2 2 2 2 2 2 2 2 2 2 2 2 2 2 2 2 2 2 2 2 2 2 2 5 5 2 2 3
3 2 2 2 2 2 5 5 2 2 2 2 2 2 2 2 2 2 2 2 2 2 2 2 2 2 2 2 5 5 2 2 2 2 2 2 2 2 2 2 2 2 2 2 2 2 2 2 2 2 2 2 2 2 5 5 2 2 3
3 2 2 2 2 2 5 5 2 2 2 2 2 2 2 2 2 2 2 2 2 2 2 2 2 2 2 2 5 5 2 2 2 2 2 2 2 2 2 2 2 2 2 2 2 2 2 2 2 2 2 2 2 2 5 5 2 2 3
3 2 2 2 2 2 5 5 2 2 2 2 2 2 2 2 2 2 2 2 2 2 2 2 2 2 2 2 5 5 2 2 2 2 2 2 2 2 2 2 2 2 2 2 2 2 2 2 2 2 2 2 2 2 5 5 2 2 3
3 2 0 8 9 8 0 6 6 6 6 6 6 5 5 5 5 5 5 5 5 5 5 5 5 5 5 5 5 5 2 2 2 2 2 2 2 2 2 2 2 2 2 2 2 2 2 2 2 2 2 2 2 2 5 5 2 2 3
3 2 5 5 5 5 5 5 5 5 5 5 5 5 5 5 5 5 5 5 5 5 5 5 5 5 5 5 5 5 2 2 2 2 2 2 2 2 2 2 2 2 2 2 2 2 2 2 2 2 2 2 2 2 5 5 2 2 3
3 2 5 5 2 2 2 2 2 2 2 2 2 2 2 2 2 2 2 2 2 2 2 2 2 2 2 2 5 5 2 2 2 2 2 2 2 2 2 2 2 2 2 2 2 2 2 2 3 3 3 3 4 4 5 5 2 2 3
3 3 5 5 2 2 2 2 2 2 2 2 2 2 2 2 2 2 2 2 2 2 2 2 2 2 2 2 5 5 2 2 2 2 2 2 2 2 2 2 2 2 2 2 2 2 2 2 3 3 3 3 4 4 5 5 2 2 3
3 3 5 5 4 2 2 2 2 2 2 2 2 2 2 2 2 2 2 2 2 2 2 2 2 2 2 2 5 5 2 2 2 2 2 2 2 2 2 2 2 2 2 2 2 2 2 2 3 3 3 3 4 4 5 5 2 2 3
3 3 5 5 4 2 2 2 2 2 2 2 2 2 2 2 2 2 2 2 2 2 2 2 2 2 2 2 5 5 2 2 2 2 2 2 2 2 2 2 2 2 2 2 2 2 2 2 4 4 4 4 4 4 5 5 2 2 3
3 3 4 3 4 2 2 2 2 2 2 2 2 2 2 2 2 2 2 2 2 2 2 2 2 2 2 2 5 5 5 5 5 5 5 5 5 5 5 5 5 5 5 5 5 5 5 5 5 5 5 5 5 5 5 5 2 2 3
3 3 3 3 4 2 2 2 2 2 2 2 2 2 2 2 2 2 2 2 2 2 2 2 2 2 2 2 5 5 5 5 5 5 5 5 5 5 5 5 5 5 5 5 5 5 5 5 5 5 5 5 5 5 5 5 2 2 3
3 3 3 3 3 3 3 3 3 3 3 3 3 3 3 3 3 3 3 3 3 3 3 3 3 3 3 3 3 3 3 3 3 3 3 3 3 3 3 3 3 3 3 3 3 3 3 3 3 3 3 3 3 3 3 3 3 3 3
3 3 3 3 3 3 3 3 3 3 3 3 3 3 3 3 3 3 3 3 3 3 3 3 3 3 3 3 3 3 3 3 3 3 3 3 3 3 3 3 3 3 3 3 3 3 3 3 3 3 3 3 3 3 3 3 3 3 3
3 3 3 3 3 3 3 3 3 3 3 3 3 3 3 3 3 3 3 3 3 3 3 3 3 3 3 3 3 3 3 3 3 3 3 3 3 3 3 3 3 3 3 3 3 3 3 3 3 3 3 3 3 3 3 3 3 3 3
3 3 3 3 3 3 3 3 3 3 3 3 3 3 3 3 3 3 3 3 3 3 3 3 3 3 3 3 3 3 3 3 3 3 3 3 3 3 3 3 3 3 3 3 3 3 3 3 3 3 3 3 3 3 3 3 3 3 3
3 3 3 3 3 3 3 3 3 3 3 3 3 3 3 3 3 3 3 3 3 3 3 3 3 3 3 3 3 3 3 3 3 3 3 3 3 3 3 3 3 3 3 3 3 3 3 3 3 3 3 3 3 3 3 3 3 3 3